4
M 1 1 N
F 15 1 S
M 2 8 N
F 15 7 S
500
20
5
17 10
GGGGGGGGGGGGGGGGG
GPPPPGGGPPPGGPPPG
GGTGTGGGPGPGPPGPG
GPTPTTGGPPPTPGGPG
GPGGGPGGPGGTGGGPG
GPPPPPPGPPPPPGPPG
GPGGGGTTTGGGTPPGG
GTTPPPPGGGGTTGPPG
GGPGGGPPPPPPGGPGG
GGGGGGGGGGGGGGGGG
