1
M 2 3 E
300
10
5
11 7
GGGGGGGGGGG
GGGGGPGGGGG
GGGGGPGGGGG
GGPPPPPPPGG
GGGGGPGGGGG
GGGGGPGGGGG
GGGGGGGGGGG