1
M 10 1 E
300
10
5
12 6
GGGGGGGGGGGG
GPPPPPPPPGPG
GGGGGGGGGGPG
GGGGGGGGGGPG
GGGGGGGGGGPG
GGGGGGGGGGGG