4
M 1 1 E
M 13 5 W
F 1 5 N
F 13 1 S
300
10
5
15 7
GGGGGGGGGGGGGGG
GPPPTTPPPTTPPPG
GGGPGGGGPGGPGPG
GPPPGGPPPGGPGPG
GPGGGGGGPGGPGPG
GPPPTTPPPTTPPPG
GGGGGGGGGGGGGGG