4
M 1 1 E
M 13 5 W
F 1 5 N
F 13 1 S
300
10
5
20 15
GGGGGGGGGGGGGGGGGGGG
GGGGGGGPPPPPGGGGGGGG
GGGGGGGPGPGPGGGGGGGG
GGGGGGGPGGGPGGGGGGGG
GGGGGGGPPPPPGGGGGGGG
GGGGGGGPGGGPGGGGGGGG
GGGGGGGPGGGPGGGGGGGG
GGGGGGGPGGGPGGGGGGGG
GGGGGGGPGGGPGGGGGGGG
GGGGGPPPPPPPPPGGGGGG
GGGGGPGGGPGGGPGGGGGG
GGGGGPGGGPGGGPGGGGGG
GGGGGPGGGPGGGPGGGGGG
GGGGGPPPPPPPPPGGGGGG
GGGGGGGGGGGGGGGGGGGG
