2
M 2 3 N
F 8 3 S
300
10
5
11 7
GGGGGGGGGGG
GGPPPPPPPGG
GGPGGGGGPGG
GGPGGGGGPGG
GGPGGGGGPGG
GGPPPPPPPGG
GGGGGGGGGGG