4
M 1 1 E
M 6 14 W
F 6 1 N
F 1 14 S
300
10
5
7 15
GGGGGGGGGGGGGGG
GPPPTTPPPTTPPPG
GGGPGGGGPGGPGPG
GPPPGGPPPGGPGPG
GPGGGGGGPGGPGPG
GPPPTTPPPTTPPPG
GGGGGGGGGGGGGGG