9
F 3 3 E
M 12 5 W
M 1 5 N
M 7 1 S
M 9 9 N
F 3 14 S
M 28 1 S
M 28 7 N
F 24 3 S
300
30
5
30 16
GGGGGGGGGGGGGGGGGGGGGGGGGGGGGG
GPTTTPPPGGPPPPPPPTTTPPPPPPPPTG
GGGTGGGTTTTPGGGGGGTGGGGGPGGPTG
GPTTGGGTGGGPGTPPPTTGGGGGPPPPTG
GPGTTPPPPGGPGTGGGGTTPPGGPGGGPG
GPGGGGGGPGGPGTGGGGPGGPGGPGGGPG
GPGGGGGGPGGPGTGPPPPGGPGGPPTTTG
GPPPPTTTPPPPPPPPGGPPTPPPPPGGPG
GPGGGGGTGGGGGGPGGGGGGGGGGPTTPG
GPGGGGGPPTTTPPPGGGGGPPTTTPGGPG
GPPPTTTPGGGTGGGPPPPGPGGGTGPPPG
GPGPGGGPGGGTGGGGGGPGPGGGTGPGGG
GPGPPPPPGGGPPPPTGTPPPGGGPPPTTG
GPGGTGGTGGGGGTGTTTGGGGGGGGPGTG
GPPPPPPTTTPPPPPPGPPPTTTPPPPTTG
GGGGGGGGGGGGGGGGGGGGGGGGGGGGGG