9
F 3 3 E 100 false
M 12 5 W 100 false
M 1 5 N 100 false
M 7 1 S 100 false
M 9 9 N 100 false
F 3 14 S 100 false
M 28 1 S 100 false
M 28 7 N 100 false
F 24 3 S 100 false
300
30
5
30 16
GGGGGGGGGGGGGGGGGGGGGGGGGGGGGG
GPTTTPPPGGPPPPPPPTTTPPPPPPPPTG
GGGTGGGTTTTPGGGGGGTGGGGGPGGPTG
GPTTGGGTGGGPGTPPPTTGGGGGPPPPTG
GPGTTPPPPGGPGTGGGGTTPPGGPGGGPG
GPGGGGGGPGGPGTGGGGPGGPGGPGGGPG
GPGGGGGGPGGPGTGPPPPGGPGGPPTTTG
GPPPPTTTPPPPPPPPGGPPTPPPPPGGPG
GPGGGGGTGGGGGGPGGGGGGGGGGPTTPG
GPGGGGGPPTTTPPPGGGGGPPTTTPGGPG
GPPPTTTPGGGTGGGPPPPGPGGGTGPPPG
GPGPGGGPGGGTGGGGGGPGPGGGTGPGGG
GPGPPPPPGGGPPPPTGTPPPGGGPPPTTG
GPGGTGGTGGGGGTGTTTGGGGGGGGPGTG
GPPPPPPTTTPPPPPPGPPPTTTPPPPTTG
GGGGGGGGGGGGGGGGGGGGGGGGGGGGGG