9
F 3 3 E 100 false
M 11 5 W 100 false
M 1 5 N 100 false
M 7 1 S 100 false
M 9 9 N 100 false
F 3 12 S 100 false
M 27 1 S 100 false
M 26 7 N 100 false
F 24 3 S 100 false
300
30
5 5 5 5 5 5 5 5
29 14
GGGGGGGGGGGGGGGGGGGGGGGGGGGGG
GPTTTPPPGGPPPPPPPTTTPPPPPPPPG
GGGTGGGTTTTPGGGGGGTGGGGGPGGPG
GPTTGGGTGGGPGTPPPTTGGGGGPPPPG
GPGTTPPPPGGPGTGGGGTTPPGGPGTGG
GPGGGGGGPGGPGTGGGGPGGPGGPGTGG
GPGGGGGGPGGPGTGPPPPGGPGGPPTTG
GPPPPTTTPPPPPPPPGGPPTPPPPPGTG
GPGGGGGTGGGGGGPGGGTGGGGGGPTTG
GPGGGGGPPTTTPPPPGGTGPPTTTPGGG
GPPPTTTPGGGTGGGPPPPGPGGGTGPPG
GPGPGGGPGGGTGGGGGGPGPGGGTGGTG
GPTPPPPPGGGPPPPTTTPPPGGGPPPTG
GGGGGGGGGGGGGGGGGGGGGGGGGGGGG