8
M 1 1 E 100 false
M 13 1 W 100 false
F 3 3 E 100 false
M 13 5 W 100 false
M 1 5 N 100 false
M 7 1 S 100 false
M 9 9 N 100 false
F 3 11 S 100 false
300
20
5 5 5 5 5 5 5 5
20 13
GGGGGGGGGGGGGGGGGGGG
GPPPTTTPPPPPPPPPPPPG
GGGGGTGGGGGGGPGGGGPG
GPPPTTGGGGGGGPGGPPPG
GPGGGTTPPPPGGPGGTGGG
GPGGGGGGGGPGGPGGTGGG
GPGGGGGGGPPTTTPPPGGG
GPPPPPGGGPGGGTGGGGGG
GPGGGPGGGPGGGTGGGGGG
GPGGGPPPPPGGGPPPPPGG
GPGGGGGGGTGGGGGGGPGG
GPPPPPPPPTTTPPPPPPGG
GGGGGGGGGGGGGGGGGGGG

