4
M 1 1 N 100 false
F 15 1 S 100 false
M 2 8 N 100 false
F 15 7 S 100 false
500
20
5 5 5 5 5 5 5 5
17 10
GGGGGGGGGGGGGGGGG
GPPPPGGGPPPGGPPPG
GGTGTGGGPGPGPPGPG
GPTPTTGGPPPTPGGPG
GPGGGPGGPGGTGGGPG
GPPPPPPGPPPPPGPPG
GPGGGGTTTGGGTPPGG
GTTPPPPGGGGTTGPPG
GGPGGGPPPPPPGGPGG
GGGGGGGGGGGGGGGGG
