9
F 3 3 E 100 false
M 11 5 W 100 false
M 1 5 N 100 false
M 7 1 S 100 false
M 9 9 N 100 false
F 3 12 S 100 false
M 24 1 S 100 false
M 21 7 N 100 false
F 24 3 S 100 false
600
30
20 5 5 23 5 5 15 32
26 14
GGGGGGGGGGGGGGGGGGGGGGGGGG
GPTTTPPPGGPPPPPPPTTTPPPPPG
GGGTGGGTTTTPGGGGGGTGGGGGPG
GPTTGGGTGGGPGTPPPTTGGGGGPG
GPGTTPPPPGGPGTGGGGTTPPGGPG
GPGGGGGGPGGPGTGGGGPGGPGGPG
GPGGGGGGPGGPGTGPPPPGGPGGPG
GPPPPTTTPPPPPPPPGGPPTPPPPG
GPGGGGGTGGGGGGPGGGTGGGGGGG
GPGGGGGPPTTTPPPPGGTGPPTTTG
GPPPTTTPGGGTGGGPPPPGPGGGTG
GPGPGGGPGGGTGGGGGGPGPGGGTG
GPTPPPPPGGGPPPPTTTPPPGGGPG
GGGGGGGGGGGGGGGGGGGGGGGGGG